"","item_id","bundle_index","total","total_nofw","nongift","nongift_nofw","branded","branded_nofw","num_of_yuanzhuang","num_of_acc_no_price","bundle_price","price_ref","price_ref_adjgift","bundle_add_on","price_ref_rel","num_of_acc_rel","premium","premium_percent","ind_firstbundle_noacc","premrel1","benchmark","total_n_of_a","total_price_of_a","premium_minus_a","perc_premrel1","premium_minus_a_perc","bundle_index1","diff","diff_minus_a"
"1",16831203027,2,14,12,2,2,3,3,0,3,2990,312,122,30,7,0,23,0.00769230769230769,FALSE,23,2750,1,15,8,0.00836363636363636,0.00290909090909091,1,2,1
"2",16831203027,3,15,13,2,2,3,3,0,3,3042,338,133,82,33,1,49,0.0161078238001315,FALSE,49,2750,1,15,34,0.0178181818181818,0.0123636363636364,1,1,0
"3",16831203027,4,20,18,3,3,5,5,0,4,3070,470,200,110,165,6,-55,-0.0179153094462541,FALSE,-55,2750,2,30,-85,-0.02,-0.0309090909090909,1,10,8
"4",16831203027,5,21,19,3,3,5,5,0,4,3110,496,211,150,191,7,-41,-0.0131832797427653,FALSE,-41,2750,1,15,-56,-0.0149090909090909,-0.0203636363636364,1,9,8
"5",16831203027,6,23,21,3,3,6,6,1,5,3150,537,222,190,232,9,-42,-0.0133333333333333,FALSE,-42,2750,1,15,-57,-0.0152727272727273,-0.0207272727272727,1,11,10
"6",16831203027,7,23,21,3,3,6,6,1,5,3220,548,233,260,243,9,17,0.00527950310559006,FALSE,17,2750,1,15,2,0.00618181818181818,0.000727272727272727,1,11,10
"7",16831203027,8,23,21,3,3,6,6,1,5,3310,570,255,350,265,9,85,0.0256797583081571,FALSE,85,2750,1,15,70,0.0309090909090909,0.0254545454545455,1,11,10
"8",18053093587,2,9,9,4,4,2,2,0,0,3548,172,117,70,-5,0,75,0.0211386696730552,FALSE,75,3280,1,40,35,0.0228658536585366,0.0106707317073171,1,2,1
"9",18053093587,3,11,10,4,4,2,2,0,1,3638,203,138,160,26,2,134,0.0368334249587686,FALSE,134,3280,3,112,22,0.0408536585365854,0.00670731707317073,1,8,5
"10",18053093587,4,11,10,4,4,2,2,0,1,3708,225,160,230,48,2,182,0.0490830636461704,FALSE,182,3280,3,112,70,0.0554878048780488,0.0213414634146341,1,8,5
"11",18053093587,5,14,13,6,6,5,5,0,1,3808,603,518,330,426,5,-96,-0.0252100840336134,FALSE,-96,3280,3,112,-208,-0.0292682926829268,-0.0634146341463415,1,11,8
"12",18053093587,6,14,13,6,6,5,5,0,1,3868,625,540,390,448,5,-58,-0.014994829369183,FALSE,-58,3280,3,112,-170,-0.0176829268292683,-0.0518292682926829,1,11,8
"13",18053093587,7,14,13,6,6,5,5,1,1,4088,645,560,610,468,5,142,0.0347358121330724,FALSE,142,3280,3,112,30,0.0432926829268293,0.00914634146341463,1,11,8
"14",18352298789,2,7,7,5,5,1,1,0,0,3800,280,245,180,65,2,115,0.0302631578947368,FALSE,115,3450,0,0,115,0.0333333333333333,0.0333333333333333,1,2,2
"15",18352298789,3,8,8,6,6,1,1,0,0,3840,295,260,220,80,3,140,0.0364583333333333,FALSE,140,3450,0,0,140,0.0405797101449275,0.0405797101449275,1,3,3
"16",18352298789,4,9,9,6,6,3,3,1,0,4090,365,310,470,150,4,320,0.078239608801956,FALSE,320,3450,0,0,320,0.0927536231884058,0.0927536231884058,1,4,4
"17",18352298789,5,9,9,6,6,2,2,0,0,3900,374,319,280,159,4,121,0.031025641025641,FALSE,121,3450,1,50,71,0.0350724637681159,0.0205797101449275,1,6,5
"18",18352298789,6,9,9,6,6,3,3,1,0,4150,415,360,530,200,4,330,0.0795180722891566,FALSE,330,3450,1,50,280,0.0956521739130435,0.0811594202898551,1,6,5
"19",18352298789,7,10,10,7,7,3,3,0,0,4100,524,469,480,309,5,171,0.0417073170731707,FALSE,171,3450,1,50,121,0.0495652173913043,0.0350724637681159,1,7,6
"20",18352298789,8,11,11,8,8,3,3,0,1,4300,515,460,680,300,6,380,0.0883720930232558,FALSE,380,3450,1,50,330,0.110144927536232,0.0956521739130435,1,8,7
"21",18820622609,2,9,9,4,4,5,5,0,0,4100,275,235,200,122,1,78,0.0190243902439024,FALSE,78,3450,1,33,45,0.0226086956521739,0.0130434782608696,1,3,2
"22",18820622609,3,9,9,4,4,5,5,0,0,4200,350,310,300,197,1,103,0.0245238095238095,FALSE,103,3450,2,63,40,0.0298550724637681,0.0115942028985507,1,5,3
"23",18999829018,2,9,9,7,7,9,9,0,0,3230,285,250,50,13,0,37,0.0114551083591331,FALSE,37,2840,1,22,15,0.0130281690140845,0.00528169014084507,1,2,1
"24",18999829018,3,9,9,7,7,9,9,0,0,3260,305,270,80,33,0,47,0.0144171779141104,FALSE,47,2840,1,22,25,0.0165492957746479,0.00880281690140845,1,2,1
"25",18999829018,4,10,10,8,8,10,10,0,0,3260,372,337,80,100,1,-20,-0.00613496932515337,FALSE,-20,2840,0,0,-20,-0.00704225352112676,-0.00704225352112676,1,1,1
"26",18999829018,5,10,10,8,8,10,10,0,0,3350,385,350,170,113,1,57,0.0170149253731343,FALSE,57,2840,1,22,35,0.0200704225352113,0.0123239436619718,1,3,2
"27",18999829018,6,10,10,8,8,10,10,0,0,3560,405,370,380,133,1,247,0.0693820224719101,FALSE,247,2840,1,22,225,0.0869718309859155,0.0792253521126761,1,3,2
"28",18999829018,7,12,12,9,9,12,12,0,0,3510,560,480,330,288,3,42,0.011965811965812,FALSE,42,2840,1,22,20,0.0147887323943662,0.00704225352112676,1,5,4
"29",18999829018,8,12,12,9,9,12,12,0,0,3610,570,490,430,298,3,132,0.0365650969529086,FALSE,132,2840,2,132,0,0.0464788732394366,0,1,7,5
"30",19999809846,2,21,19,7,7,5,5,0,5,3120,326,188,40,11,0,29,0.00929487179487179,FALSE,29,2850,1,22,7,0.0101754385964912,0.00245614035087719,1,2,1
"31",19999809846,3,23,21,9,9,5,5,0,5,3190,506,368,110,191,2,-81,-0.0253918495297806,FALSE,-81,2850,2,72,-153,-0.0284210526315789,-0.0536842105263158,1,6,4
"32",19999809846,4,26,24,10,10,6,6,0,5,3250,665,407,170,350,5,-180,-0.0553846153846154,FALSE,-180,2850,1,50,-230,-0.0631578947368421,-0.0807017543859649,1,7,6
"33",19999809846,5,27,25,10,10,6,6,0,5,3290,731,418,210,416,6,-206,-0.0626139817629179,FALSE,-206,2850,2,72,-278,-0.072280701754386,-0.0975438596491228,1,10,8
"34",19999809846,6,28,26,10,10,7,7,1,5,3350,755,432,270,440,7,-170,-0.0507462686567164,FALSE,-170,2850,1,50,-220,-0.0596491228070175,-0.0771929824561404,1,9,8
"35",19999809846,7,29,27,10,10,8,8,1,5,3400,781,443,320,466,8,-146,-0.0429411764705882,FALSE,-146,2850,2,72,-218,-0.0512280701754386,-0.0764912280701754,1,12,10
"36",19999809846,8,29,27,0,0,8,8,1,5,3470,803,0,390,488,8,-98,-0.0282420749279539,FALSE,-98,2850,2,72,-170,-0.0343859649122807,-0.0596491228070175,1,12,10
"37",20167630571,2,14,14,14,14,4,4,0,0,3080,350,350,70,70,2,0,0,FALSE,0,2780,1,50,-50,0,-0.0179856115107914,1,4,3
"38",20167630571,3,14,14,14,14,4,4,0,0,3120,361,361,110,81,2,29,0.00929487179487179,FALSE,29,2780,2,72,-43,0.010431654676259,-0.0154676258992806,1,6,4
"39",20167630571,4,14,14,14,14,4,4,0,0,3190,398,398,180,118,2,62,0.019435736677116,FALSE,62,2780,3,87,-25,0.0223021582733813,-0.00899280575539568,1,8,5
"40",20167630571,5,16,16,16,16,4,4,0,0,3450,448,448,440,168,4,272,0.0788405797101449,FALSE,272,2780,2,72,200,0.097841726618705,0.0719424460431655,1,8,6
"41",20186366493,2,17,15,10,8,1,1,2,2,3380,410,185,40,40,1,0,0,FALSE,0,3110,1,20,-20,0,-0.00643086816720257,1,3,2
"42",20186366493,3,17,15,10,8,1,1,2,2,3410,415,190,70,45,1,25,0.00733137829912024,FALSE,25,3110,1,20,5,0.00803858520900321,0.00160771704180064,1,3,2
"43",20186366493,4,17,15,10,8,1,1,2,2,3450,430,205,110,60,1,50,0.0144927536231884,FALSE,50,3110,0,0,50,0.0160771704180064,0.0160771704180064,1,1,1
"44",20186366493,5,18,16,11,9,1,1,2,2,3500,470,245,160,100,2,60,0.0171428571428571,FALSE,60,3110,1,20,40,0.0192926045016077,0.0128617363344051,1,4,3
"45",20186366493,6,18,16,11,9,1,1,2,2,3530,475,250,190,105,2,85,0.0240793201133144,FALSE,85,3110,1,20,65,0.0273311897106109,0.0209003215434084,1,4,3
"46",20186366493,7,18,16,11,9,1,1,3,2,3610,485,260,270,115,2,155,0.0429362880886427,FALSE,155,3110,1,20,135,0.0498392282958199,0.0434083601286174,1,4,3
"47",20186366493,8,18,16,11,9,1,1,3,2,3640,490,265,300,120,2,180,0.0494505494505494,FALSE,180,3110,1,20,160,0.0578778135048231,0.0514469453376206,1,4,3
"48",20373091017,2,9,9,2,2,0,0,1,0,3210,245,60,20,15,0,5,0.00155763239875389,FALSE,5,2950,1,40,-35,0.00169491525423729,-0.011864406779661,1,2,1
"49",20373091017,3,9,9,2,2,0,0,1,0,3260,280,60,70,50,0,20,0.00613496932515337,FALSE,20,2950,1,40,-20,0.00677966101694915,-0.00677966101694915,1,2,1
"50",20728727154,2,13,13,8,8,3,3,0,0,3658,415,350,120,95,2,25,0.00683433570256971,FALSE,25,3358,2,35,-10,0.00744490768314473,-0.00297796307325789,1,6,4
"51",20728727154,3,13,13,8,8,3,3,0,0,3768,535,470,230,215,2,15,0.00398089171974522,FALSE,15,3358,3,65,-50,0.00446694460988684,-0.0148898153662895,1,8,5
"52",20728727154,4,14,14,8,8,3,3,0,0,3958,665,470,420,345,3,75,0.0189489641232946,FALSE,75,3358,3,65,10,0.0223347230494342,0.00297796307325789,1,9,6
"53",20728727154,5,14,14,8,8,4,4,1,1,4088,550,355,550,230,3,320,0.0782778864970646,FALSE,320,3358,5,225,95,0.0952948183442525,0.02829064919595,1,13,8
"54",20728727154,6,14,14,8,8,5,5,2,0,4188,640,445,650,320,3,330,0.0787965616045845,FALSE,330,3358,5,225,105,0.0982727814175104,0.0312686122692079,1,13,8
"55",20728727154,7,14,14,8,8,5,5,2,0,4358,660,465,820,340,3,480,0.110142267094998,FALSE,480,3358,5,225,255,0.142942227516379,0.0759380583680762,1,13,8
"56",20728727154,8,16,16,10,10,5,5,1,0,4500,770,575,962,450,5,512,0.113777777777778,FALSE,512,3358,5,225,287,0.152471709350804,0.0854675402025015,1,15,10
"57",23896264169,2,11,10,4,4,9,9,0,1,3450,324,264,100,65,2,35,0.0101449275362319,FALSE,35,3150,1,80,-45,0.0111111111111111,-0.0142857142857143,1,4,3
"58",23896264169,3,10,9,3,3,8,8,0,1,3450,223,163,100,-36,1,136,0.0394202898550725,FALSE,136,3150,2,119,17,0.0431746031746032,0.0053968253968254,1,5,3
"59",23896264169,4,12,11,4,4,10,10,0,1,3550,343,263,200,84,3,116,0.0326760563380282,FALSE,116,3150,2,119,-3,0.0368253968253968,-0.000952380952380952,1,7,5
"60",23896264169,5,13,12,5,5,11,11,1,1,3650,415,335,300,156,4,144,0.0394520547945205,FALSE,144,3150,2,119,25,0.0457142857142857,0.00793650793650794,1,8,6
"61",23896264169,6,13,12,5,5,11,11,1,1,3800,593,513,450,334,4,116,0.0305263157894737,FALSE,116,3150,3,219,-103,0.0368253968253968,-0.0326984126984127,1,10,7
"62",23896264169,7,13,12,5,5,11,11,1,1,3920,653,573,570,394,4,176,0.0448979591836735,FALSE,176,3150,3,219,-43,0.0558730158730159,-0.0136507936507937,1,10,7
"63",23896264169,8,13,12,6,6,11,11,1,1,4050,697,637,700,438,4,262,0.0646913580246914,FALSE,262,3150,3,219,43,0.0831746031746032,0.0136507936507937,1,10,7
"64",23924620234,2,16,16,6,6,3,3,0,0,3540,327,202,40,50,2,-10,-0.00282485875706215,FALSE,-10,3400,1,22,-32,-0.00294117647058824,-0.00941176470588235,1,4,3
"65",23924620234,3,16,16,6,6,3,3,0,0,3580,360,235,80,83,2,-3,-0.000837988826815642,FALSE,-3,3400,1,22,-25,-0.000882352941176471,-0.00735294117647059,1,4,3
"66",23924620234,4,20,20,8,8,7,7,2,0,3680,547,352,180,270,6,-90,-0.0244565217391304,FALSE,-90,3400,0,0,-90,-0.0264705882352941,-0.0264705882352941,1,6,6
"67",23924620234,5,20,20,8,8,7,7,2,0,3720,547,352,220,270,6,-50,-0.0134408602150538,FALSE,-50,3400,1,22,-72,-0.0147058823529412,-0.0211764705882353,1,8,7
"68",23924620234,6,20,20,8,8,7,7,2,0,3760,580,385,260,303,6,-43,-0.011436170212766,FALSE,-43,3400,1,22,-65,-0.0126470588235294,-0.0191176470588235,1,8,7
"69",23969324559,2,16,16,12,12,5,5,0,0,3160,395,320,60,135,3,-75,-0.0237341772151899,FALSE,-75,2900,2,65,-140,-0.0258620689655172,-0.0482758620689655,1,7,5
"70",23969324559,3,18,18,14,14,7,7,0,0,3180,439,364,80,179,5,-99,-0.0311320754716981,FALSE,-99,2900,2,65,-164,-0.0341379310344828,-0.056551724137931,1,9,7
"71",23969324559,4,20,20,15,15,9,9,0,0,3240,489,384,140,229,7,-89,-0.0274691358024691,FALSE,-89,2900,3,105,-194,-0.0306896551724138,-0.0668965517241379,1,13,10
"72",24291960195,2,5,5,5,5,5,5,0,0,5130,148,148,100,53,1,47,0.00916179337231969,FALSE,47,4099,1,15,32,0.0114662112710417,0.00780678214198585,1,3,2
"73",24291960195,3,7,7,7,7,6,6,0,0,5250,258,258,220,163,3,57,0.0108571428571429,FALSE,57,4099,2,65,-8,0.0139058306904123,-0.00195169553549646,1,7,5
"74",24291960195,4,7,7,7,7,6,6,1,0,5470,278,278,440,183,3,257,0.0469835466179159,FALSE,257,4099,2,65,192,0.0626982190778239,0.0468406928519151,1,7,5
"75",24291960195,5,7,7,7,7,6,6,0,0,5450,248,248,420,153,3,267,0.0489908256880734,FALSE,267,4099,2,65,202,0.0651378384971944,0.0492803122712857,1,7,5
"76",24291960195,6,7,7,7,7,6,6,0,0,5510,270,270,480,175,3,305,0.0553539019963702,FALSE,305,4099,2,65,240,0.0744083922908026,0.0585508660648939,1,7,5
"77",24291960195,7,7,7,7,7,6,6,1,0,5730,290,290,700,195,3,505,0.0881326352530541,FALSE,505,4099,2,65,440,0.123200780678214,0.107343254452305,1,7,5
"78",24319152517,2,7,7,7,7,0,0,1,0,3798,215,215,200,58,2,142,0.0373880989994734,FALSE,142,3348,1,22,120,0.0424133811230585,0.03584229390681,1,4,3
"79",24319152517,3,11,11,11,11,0,0,0,0,4098,538,538,500,381,6,119,0.0290385553928746,FALSE,119,3348,3,137,-18,0.0355436081242533,-0.00537634408602151,1,12,9
"80",24319152517,4,11,11,11,11,0,0,0,0,4298,438,438,700,281,6,419,0.0974872033503955,FALSE,419,3348,3,137,282,0.125149342891278,0.0842293906810036,1,12,9
"81",24319152517,5,12,12,12,12,0,0,0,0,4598,593,593,1000,436,7,564,0.122662026968247,FALSE,564,3348,3,137,427,0.168458781362007,0.127538829151732,1,13,10
"82",24596036343,2,12,12,7,7,6,6,1,0,3319,295,220,60,80,2,-20,-0.00602591141910214,FALSE,-20,3049,0,0,-20,-0.00655952771400459,-0.00655952771400459,1,2,2
"83",24596036343,3,13,13,8,8,7,7,1,0,3479,335,260,220,120,3,100,0.0287438919229664,FALSE,100,3049,1,20,80,0.032797638570023,0.0262381108560184,1,5,4
"84",24596036343,4,14,14,9,9,7,7,1,1,3599,369,294,340,154,4,186,0.0516810225062517,FALSE,186,3049,2,25,161,0.0610036077402427,0.052804198097737,1,8,6
"85",24596036343,5,14,14,9,9,7,7,1,2,3799,289,214,540,74,4,466,0.12266385891024,FALSE,466,3049,2,25,441,0.152836995736307,0.144637586093801,1,8,6
"86",24596036343,6,15,15,10,10,8,8,1,2,4049,475,400,790,260,5,530,0.130896517658681,FALSE,530,3049,2,25,505,0.173827484421122,0.165628074778616,1,9,7
"87",24596036343,7,16,16,11,11,9,9,1,0,3839,690,615,580,475,6,105,0.0273508726230789,FALSE,105,3049,1,20,85,0.0344375204985241,0.0278779927845195,1,8,7
"88",24596036343,8,17,17,12,12,9,9,1,2,4149,675,600,890,460,7,430,0.103639431188238,FALSE,430,3049,2,25,405,0.141029845851099,0.132830436208593,1,11,9
"89",25673844634,2,17,15,6,5,3,2,1,3,3120,398,183,30,171,6,-141,-0.0451923076923077,FALSE,-141,2940,1,22,-163,-0.0479591836734694,-0.0554421768707483,1,8,7
"90",25673844634,3,17,15,6,5,3,2,1,3,3160,420,205,70,193,6,-123,-0.0389240506329114,FALSE,-123,2940,1,22,-145,-0.0418367346938776,-0.0493197278911565,1,8,7
"91",25673844634,4,17,15,6,5,3,2,1,3,3240,485,270,150,258,6,-108,-0.0333333333333333,FALSE,-108,2940,1,22,-130,-0.036734693877551,-0.0442176870748299,1,8,7
"92",26519380192,2,15,15,8,8,9,9,0,2,3600,201,123,110,0,1,110,0.0305555555555556,FALSE,110,3260,1,30,80,0.0337423312883436,0.0245398773006135,1,3,2
"93",26519380192,3,15,15,8,8,9,9,0,1,3710,323,245,220,122,1,98,0.0264150943396226,FALSE,98,3260,2,63,35,0.0300613496932515,0.0107361963190184,1,5,3
"94",26519380192,4,15,15,8,8,9,9,1,1,3820,323,245,330,122,1,208,0.0544502617801047,FALSE,208,3260,4,78,130,0.0638036809815951,0.0398773006134969,1,9,5
"95",26519380192,5,17,17,10,10,10,10,1,1,3930,463,385,440,262,3,178,0.04529262086514,FALSE,178,3260,4,78,100,0.054601226993865,0.0306748466257669,1,11,7
"96",26519380192,6,17,17,10,10,10,10,1,1,4140,568,490,650,367,3,283,0.0683574879227053,FALSE,283,3260,4,78,205,0.0868098159509202,0.0628834355828221,1,11,7
"97",26519380192,7,17,17,10,10,10,10,1,1,4640,728,650,1150,527,3,623,0.13426724137931,FALSE,623,3260,4,78,545,0.191104294478528,0.167177914110429,1,11,7
"98",27462844289,2,12,12,4,4,6,6,2,1,3260,279,188,40,21,0,19,0.00582822085889571,FALSE,19,3060,2,52,-33,0.00620915032679739,-0.0107843137254902,1,4,2
"99",27462844289,3,13,13,5,5,7,7,3,1,3460,369,278,240,111,1,129,0.0372832369942197,FALSE,129,3060,1,22,107,0.042156862745098,0.0349673202614379,1,3,2
"100",27462844289,4,13,13,5,5,7,7,3,1,3540,391,300,320,133,1,187,0.0528248587570621,FALSE,187,3060,1,22,165,0.0611111111111111,0.053921568627451,1,3,2
"101",27462844289,5,15,15,7,7,9,9,3,1,3960,543,452,740,285,3,455,0.11489898989899,FALSE,455,3060,2,122,333,0.148692810457516,0.108823529411765,1,7,5
"102",27462844289,6,15,15,7,7,9,9,3,1,4040,565,474,820,307,3,513,0.126980198019802,FALSE,513,3060,2,122,391,0.167647058823529,0.127777777777778,1,7,5
"103",35540978058,2,11,11,5,5,4,4,0,0,3338,389,234,210,132,2,78,0.0233672857998802,FALSE,78,2998,1,22,56,0.0260173448965977,0.018679119412942,1,4,3
"104",35540978058,3,12,12,6,6,5,5,0,1,3448,389,234,320,132,3,188,0.0545243619489559,FALSE,188,2998,1,22,166,0.0627084723148766,0.0553702468312208,1,5,4
"105",35540978058,4,12,12,6,6,5,5,0,1,3598,415,260,470,158,3,312,0.0867148415786548,FALSE,312,2998,1,22,290,0.104069379586391,0.0967311541027352,1,5,4
"106",35540978058,5,12,12,6,6,5,5,1,0,3798,509,354,670,252,3,418,0.110057925223802,FALSE,418,2998,1,22,396,0.13942628418946,0.132088058705804,1,5,4
"107",35674260254,2,12,12,10,10,2,2,1,0,2930,340,290,30,7,0,23,0.00784982935153584,FALSE,23,2710,1,15,8,0.00848708487084871,0.0029520295202952,1,2,1
"108",35674260254,3,12,12,10,10,2,2,1,0,2970,351,301,70,18,0,52,0.0175084175084175,FALSE,52,2710,1,15,37,0.0191881918819188,0.0136531365313653,1,2,1
"109",35674260254,4,12,12,10,10,2,2,1,0,3050,373,323,150,40,0,110,0.0360655737704918,FALSE,110,2710,1,15,95,0.040590405904059,0.0350553505535055,1,2,1
"110",35674260254,5,13,13,11,11,2,2,2,0,3090,415,365,190,82,1,108,0.0349514563106796,FALSE,108,2710,1,15,93,0.0398523985239852,0.0343173431734317,1,3,2
"111",35674260254,6,13,13,11,11,2,2,2,0,3170,426,376,270,93,1,177,0.0558359621451104,FALSE,177,2710,1,15,162,0.0653136531365314,0.0597785977859779,1,3,2
"112",35674260254,7,13,13,11,11,2,2,2,0,3210,448,398,310,115,1,195,0.0607476635514019,FALSE,195,2710,1,15,180,0.0719557195571956,0.0664206642066421,1,3,2
"113",35674260254,8,16,16,11,11,2,2,2,0,3250,508,398,350,175,4,175,0.0538461538461538,FALSE,175,2710,1,15,160,0.0645756457564576,0.0590405904059041,1,6,5
"114",36513357018,2,12,12,12,12,3,3,1,0,3100,315,315,600,205,11,395,0.12741935483871,FALSE,395,2950,0,0,395,0.133898305084746,0.133898305084746,1,11,11
"115",36513357018,3,13,13,13,13,4,4,1,0,3200,372,372,700,262,12,438,0.136875,FALSE,438,2950,0,0,438,0.148474576271186,0.148474576271186,1,12,12
"116",36513357018,4,13,13,13,13,4,4,1,0,3250,383,383,750,273,12,477,0.146769230769231,FALSE,477,2950,0,0,477,0.161694915254237,0.161694915254237,1,12,12
"117",36513357018,5,13,13,13,13,4,4,1,0,3300,405,405,800,295,12,505,0.153030303030303,FALSE,505,2950,0,0,505,0.171186440677966,0.171186440677966,1,12,12
"118",36574928690,2,8,8,8,8,2,2,0,0,3040,210,210,80,110,2,-30,-0.00986842105263158,FALSE,-30,2860,0,0,-30,-0.0104895104895105,-0.0104895104895105,1,2,2
"119",36574928690,3,9,9,9,9,2,2,1,0,3150,370,370,190,270,3,-80,-0.0253968253968254,FALSE,-80,2860,2,50,-130,-0.027972027972028,-0.0454545454545455,1,7,5
"120",36574928690,4,9,9,9,9,2,2,1,0,3260,420,420,300,320,3,-20,-0.00613496932515337,FALSE,-20,2860,2,50,-70,-0.00699300699300699,-0.0244755244755245,1,7,5
"121",36613205733,2,18,18,15,15,6,6,0,2,3059,305,265,60,45,2,15,0.004903563255966,FALSE,15,2849,2,65,-50,0.00526500526500526,-0.0175500175500175,1,6,4
"122",36613205733,3,19,19,16,16,7,7,0,2,3139,385,345,140,125,3,15,0.00477859190825104,FALSE,15,2849,2,65,-50,0.00526500526500526,-0.0175500175500175,1,7,5
"123",36613205733,4,21,21,18,18,7,7,0,2,3239,425,385,240,165,5,75,0.0231552948440877,FALSE,75,2849,2,65,10,0.0263250263250263,0.00351000351000351,1,9,7
"124",36613205733,5,22,22,19,19,8,8,0,2,3459,495,455,460,235,6,225,0.0650477016478751,FALSE,225,2849,3,105,120,0.078975078975079,0.0421200421200421,1,12,9
"125",36613205733,6,23,23,20,20,9,9,0,2,3589,580,540,590,320,7,270,0.075229869044302,FALSE,270,2849,3,105,165,0.0947700947700948,0.0579150579150579,1,13,10
"126",36910165248,2,7,6,6,5,0,0,0,1,3118,170,160,40,5,0,35,0.0112251443232842,FALSE,35,2858,1,25,10,0.0122463261021693,0.00349895031490553,1,2,1
"127",36910165248,3,12,10,11,9,0,0,0,2,3228,375,365,150,210,5,-60,-0.0185873605947955,FALSE,-60,2858,0,0,-60,-0.0209937018894332,-0.0209937018894332,1,5,5
"128",36910165248,4,12,10,11,9,0,0,0,2,3268,380,370,190,215,5,-25,-0.0076499388004896,FALSE,-25,2858,1,25,-50,-0.00874737578726382,-0.0174947515745276,1,7,6
"129",36910165248,5,12,10,11,9,0,0,0,2,3358,405,395,280,240,5,40,0.0119118522930316,FALSE,40,2858,1,25,15,0.0139958012596221,0.00524842547235829,1,7,6
"130",36910165248,6,14,12,13,11,1,1,0,2,3418,480,470,340,315,7,25,0.00731421884142774,FALSE,25,2858,1,25,0,0.00874737578726382,0,1,9,8
"131",36910165248,7,14,12,13,11,1,1,0,2,3508,505,495,430,340,7,90,0.0256556442417332,FALSE,90,2858,1,25,65,0.0314905528341498,0.0227431770468859,1,9,8
"132",36910165248,8,16,14,15,13,1,1,0,2,3588,655,645,510,490,9,20,0.00557413600891862,FALSE,20,2858,1,25,-5,0.00699790062981106,-0.00174947515745276,1,11,10
"133",36982442137,2,8,8,4,4,0,0,0,0,3665,148,98,70,-39,-2,109,0.0297407912687585,FALSE,109,3390,3,72,37,0.0321533923303835,0.0109144542772861,1,4,1
"134",36982442137,3,10,10,6,6,0,0,0,0,3755,203,153,160,16,0,144,0.0383488681757656,FALSE,144,3390,5,132,12,0.0424778761061947,0.00353982300884956,1,10,5
"135",36982442137,4,10,10,7,7,0,0,0,0,3825,225,180,230,38,0,192,0.0501960784313725,FALSE,192,3390,5,132,60,0.0566371681415929,0.0176991150442478,1,10,5
"136",36982442137,5,13,12,10,9,0,0,0,1,3925,333,268,330,146,3,184,0.0468789808917197,FALSE,184,3390,5,132,52,0.0542772861356932,0.0153392330383481,1,13,8
"137",36982442137,6,14,13,11,10,0,0,0,1,3985,375,340,390,188,4,202,0.0506900878293601,FALSE,202,3390,5,132,70,0.0595870206489676,0.0206489675516224,1,14,9
"138",36982442137,7,14,13,11,10,0,0,1,2,4205,295,260,610,108,4,502,0.119381688466112,FALSE,502,3390,5,132,370,0.148082595870207,0.109144542772861,1,14,9
"139",37241107923,2,6,6,6,6,2,2,0,0,2840,279,279,90,65,1,25,0.00880281690140845,FALSE,25,2680,1,25,0,0.00932835820895522,0,1,3,2
"140",37443266749,2,16,14,3,1,2,2,0,2,3596,313,33,31,11,0,20,0.00556173526140156,FALSE,20,3280,1,22,-2,0.00609756097560976,-0.000609756097560976,1,2,1
"141",37443266749,3,16,14,3,1,2,2,0,2,3645,335,55,80,33,0,47,0.0128943758573388,FALSE,47,3280,1,22,25,0.0143292682926829,0.00762195121951219,1,2,1
"142",37443266749,4,17,15,3,1,2,2,0,2,3625,352,22,60,50,1,10,0.00275862068965517,FALSE,10,3280,0,0,10,0.00304878048780488,0.00304878048780488,1,1,1
"143",37443266749,5,17,15,3,1,2,2,0,2,3655,363,33,90,61,1,29,0.0079343365253078,FALSE,29,3280,1,22,7,0.00884146341463415,0.00213414634146341,1,3,2
"144",37443266749,6,17,15,3,1,2,2,0,2,3705,385,55,140,83,1,57,0.0153846153846154,FALSE,57,3280,1,22,35,0.0173780487804878,0.0106707317073171,1,3,2
"145",37745552927,2,9,9,6,6,1,1,0,0,3679,285,250,170,90,3,80,0.0217450394128839,FALSE,80,3299,1,25,55,0.0242497726583813,0.0166717187026372,1,5,4
"146",37745552927,3,11,11,7,7,2,2,0,0,3879,420,375,370,225,5,145,0.0373807682392369,FALSE,145,3299,1,25,120,0.0439527129433162,0.036374658987572,1,7,6
"147",37745552927,4,15,15,10,10,2,2,1,0,4129,635,580,620,440,9,180,0.0435940905788327,FALSE,180,3299,1,25,155,0.054561988481358,0.0469839345256138,1,11,10
"148",37994506504,2,12,12,1,1,4,4,0,0,3220,270,22,30,7,0,23,0.00714285714285714,FALSE,23,3040,1,15,8,0.00756578947368421,0.00263157894736842,1,2,1
"149",37994506504,3,12,12,1,1,4,4,0,0,3280,283,35,90,20,0,70,0.0213414634146341,FALSE,70,3040,1,15,55,0.0230263157894737,0.0180921052631579,1,2,1
"150",37994506504,4,14,14,2,2,5,5,0,0,3380,378,80,190,115,2,75,0.022189349112426,FALSE,75,3040,1,15,60,0.0246710526315789,0.0197368421052632,1,4,3
"151",37994506504,5,13,13,2,2,5,5,1,0,3370,338,90,180,75,1,105,0.0311572700296736,FALSE,105,3040,0,0,105,0.0345394736842105,0.0345394736842105,1,1,1
"152",37994506504,6,14,14,2,2,6,6,1,0,3400,380,97,210,117,2,93,0.0273529411764706,FALSE,93,3040,1,15,78,0.0305921052631579,0.0256578947368421,1,4,3
"153",37994506504,7,14,14,2,2,6,6,1,0,3460,402,119,270,139,2,131,0.0378612716763006,FALSE,131,3040,1,15,116,0.0430921052631579,0.0381578947368421,1,4,3
"154",37994506504,8,16,16,3,3,7,7,1,0,3560,488,155,370,225,4,145,0.0407303370786517,FALSE,145,3040,1,15,130,0.0476973684210526,0.0427631578947368,1,6,5
"155",38631814095,2,12,12,9,9,4,4,1,0,3230,410,365,120,92,1,28,0.0086687306501548,FALSE,28,2850,3,98,-70,0.00982456140350877,-0.0245614035087719,1,7,4
"156",38631814095,3,13,13,10,10,4,4,2,0,3350,450,405,240,132,2,108,0.0322388059701493,FALSE,108,2850,4,138,-30,0.0378947368421053,-0.0105263157894737,1,10,6
"157",38663832002,2,15,13,7,5,2,2,0,3,3180,270,142,30,7,0,23,0.00723270440251572,FALSE,23,3000,1,15,8,0.00766666666666667,0.00266666666666667,1,2,1
"158",38663832002,3,15,13,7,5,2,2,0,3,3240,281,153,90,18,0,72,0.0222222222222222,FALSE,72,3000,1,15,57,0.024,0.019,1,2,1
"159",38663832002,4,17,15,8,6,3,3,0,3,3340,363,225,190,100,2,90,0.0269461077844311,FALSE,90,3000,1,15,75,0.03,0.025,1,4,3
"160",38663832002,5,16,14,8,6,3,3,1,3,3330,338,210,180,75,1,105,0.0315315315315315,FALSE,105,3000,0,0,105,0.035,0.035,1,1,1
"161",38663832002,6,17,15,9,7,3,3,1,3,3360,385,257,210,122,2,88,0.0261904761904762,FALSE,88,3000,1,15,73,0.0293333333333333,0.0243333333333333,1,4,3
"162",38663832002,7,17,15,9,7,3,3,1,3,3420,396,268,270,133,2,137,0.0400584795321637,FALSE,137,3000,1,15,122,0.0456666666666667,0.0406666666666667,1,4,3
"163",38663832002,8,19,17,11,9,4,4,1,3,3520,478,350,370,215,4,155,0.0440340909090909,FALSE,155,3000,1,15,140,0.0516666666666667,0.0466666666666667,1,6,5
"164",38708270318,2,12,12,1,1,2,2,0,0,3230,270,22,30,7,0,23,0.00712074303405573,FALSE,23,3050,1,15,8,0.00754098360655738,0.00262295081967213,1,2,1
"165",38708270318,3,12,12,1,1,2,2,0,0,3290,283,35,90,20,0,70,0.0212765957446809,FALSE,70,3050,1,15,55,0.0229508196721311,0.0180327868852459,1,2,1
"166",38708270318,4,14,14,1,1,2,2,0,0,3390,363,55,190,100,2,90,0.0265486725663717,FALSE,90,3050,1,15,75,0.0295081967213115,0.0245901639344262,1,4,3
"167",38708270318,5,13,13,2,2,3,3,1,0,3350,338,90,150,75,1,75,0.0223880597014925,FALSE,75,3050,0,0,75,0.0245901639344262,0.0245901639344262,1,1,1
"168",38708270318,6,14,14,2,2,3,3,1,0,3380,380,97,180,117,2,63,0.0186390532544379,FALSE,63,3050,1,15,48,0.020655737704918,0.0157377049180328,1,4,3
"169",38708270318,7,14,14,2,2,3,3,1,0,3440,393,110,240,130,2,110,0.0319767441860465,FALSE,110,3050,1,15,95,0.0360655737704918,0.0311475409836066,1,4,3
"170",38708270318,8,16,16,2,2,3,3,1,0,3760,473,130,560,210,4,350,0.0930851063829787,FALSE,350,3050,1,15,335,0.114754098360656,0.10983606557377,1,6,5
"171",39237426326,2,14,13,14,13,3,3,0,1,3150,288,288,70,60,1,10,0.00317460317460317,FALSE,10,2850,0,0,10,0.00350877192982456,0.00350877192982456,1,1,1
"172",39237426326,3,14,13,14,13,3,3,0,1,3190,293,293,110,65,1,45,0.0141065830721003,FALSE,45,2850,1,25,20,0.0157894736842105,0.00701754385964912,1,3,2
"173",39237426326,4,14,13,14,13,3,3,0,1,3280,318,318,200,90,1,110,0.0335365853658537,FALSE,110,2850,1,25,85,0.0385964912280702,0.0298245614035088,1,3,2
"174",40148868087,2,17,16,1,1,2,2,0,1,3080,440,25,50,5,0,45,0.0146103896103896,FALSE,45,3030,1,20,25,0.0148514851485149,0.00825082508250825,1,2,1
"175",40148868087,3,17,16,2,2,2,2,0,1,3130,445,40,100,10,0,90,0.0287539936102236,FALSE,90,3030,1,20,70,0.0297029702970297,0.0231023102310231,1,2,1
"176",40148868087,4,17,16,1,1,1,1,0,1,3160,455,20,130,20,0,110,0.0348101265822785,FALSE,110,3030,1,20,90,0.0363036303630363,0.0297029702970297,1,2,1
"177",40148868087,5,17,16,1,1,1,1,0,1,3190,460,25,160,25,0,135,0.0423197492163009,FALSE,135,3030,2,40,95,0.0445544554455446,0.0313531353135314,1,4,2
"178",40148868087,6,17,16,1,1,1,1,0,1,3230,465,30,200,30,0,170,0.0526315789473684,FALSE,170,3030,2,40,130,0.0561056105610561,0.0429042904290429,1,4,2
"179",40148868087,7,17,16,1,1,1,1,0,1,3280,490,55,250,55,0,195,0.0594512195121951,FALSE,195,3030,2,40,155,0.0643564356435644,0.0511551155115512,1,4,2
"180",40175359932,2,18,16,7,5,0,0,1,2,3200,325,142,80,7,0,73,0.0228125,FALSE,73,3000,1,15,58,0.0243333333333333,0.0193333333333333,1,2,1
"181",40175359932,3,18,16,8,6,0,0,1,2,3250,336,158,130,18,0,112,0.0344615384615385,FALSE,112,3000,1,15,97,0.0373333333333333,0.0323333333333333,1,2,1
"182",40175359932,4,19,17,8,6,0,0,2,2,3350,393,218,230,75,1,155,0.0462686567164179,FALSE,155,3000,0,0,155,0.0516666666666667,0.0516666666666667,1,1,1
"183",40175359932,5,19,17,9,7,0,0,2,2,3400,400,230,280,82,1,198,0.0582352941176471,FALSE,198,3000,1,15,183,0.066,0.061,1,3,2
"184",40175359932,6,19,17,6,4,0,0,2,2,3450,411,121,330,93,1,237,0.068695652173913,FALSE,237,3000,1,15,222,0.079,0.074,1,3,2
"185",40175359932,7,19,17,8,6,0,0,2,2,3510,433,188,390,115,1,275,0.0783475783475783,FALSE,275,3000,1,15,260,0.0916666666666667,0.0866666666666667,1,3,2
"186",40452911197,2,8,7,4,3,2,1,1,1,3080,222,62,30,5,0,25,0.00811688311688312,FALSE,25,2899,1,15,10,0.00862366333218351,0.0034494653328734,1,2,1
"187",40452911197,3,8,7,4,3,2,1,1,1,3120,237,77,70,20,0,50,0.016025641025641,FALSE,50,2899,1,15,35,0.017247326664367,0.0120731286650569,1,2,1
"188",40452911197,4,8,7,4,3,2,1,1,1,3180,261,101,130,44,0,86,0.0270440251572327,FALSE,86,2899,1,15,71,0.0296654018627113,0.0244912038634012,1,2,1
"189",40452911197,5,13,12,5,4,2,1,1,1,3150,355,107,100,138,5,-38,-0.0120634920634921,FALSE,-38,2899,0,0,-38,-0.0131079682649189,-0.0131079682649189,1,5,5
"190",40452911197,6,13,12,5,4,2,1,1,1,3180,360,112,130,143,5,-13,-0.00408805031446541,FALSE,-13,2899,1,15,-28,-0.00448430493273543,-0.00965850293204553,1,7,6
"191",40452911197,7,13,12,5,4,2,1,1,1,3220,375,127,170,158,5,12,0.00372670807453416,FALSE,12,2899,1,15,-3,0.00413935839944809,-0.00103483959986202,1,7,6
"192",40452911197,8,13,12,5,4,2,1,1,1,3280,399,151,230,182,5,48,0.0146341463414634,FALSE,48,2899,1,15,33,0.0165574335977923,0.0113832355984822,1,7,6
"193",40565901878,2,8,8,8,8,2,2,0,0,3655,110,110,165,22,2,143,0.039124487004104,FALSE,143,3450,0,0,143,0.0414492753623188,0.0414492753623188,1,2,2
"194",40565901878,3,12,12,12,12,5,5,0,0,3675,353,353,185,265,6,-80,-0.0217687074829932,FALSE,-80,3450,0,0,-80,-0.0231884057971014,-0.0231884057971014,1,6,6
"195",41802068265,2,14,14,5,5,1,1,0,0,3240,378,183,40,50,0,-10,-0.00308641975308642,FALSE,-10,2980,2,35,-45,-0.00335570469798658,-0.0151006711409396,1,4,2
"196",41802068265,3,16,16,5,5,1,1,0,0,3310,388,173,110,60,2,50,0.0151057401812689,FALSE,50,2980,2,75,-25,0.0167785234899329,-0.00838926174496644,1,4,2
"197",41802068265,4,19,19,9,9,2,2,0,0,3390,508,303,190,180,5,10,0.00294985250737463,FALSE,10,2980,2,75,-65,0.00335570469798658,-0.0218120805369128,1,9,7
"198",41802068265,5,19,19,9,9,2,2,0,0,3460,533,328,260,205,5,55,0.0158959537572254,FALSE,55,2980,2,75,-20,0.0184563758389262,-0.00671140939597315,1,9,7
"199",41802068265,6,20,20,10,10,5,5,1,0,3530,563,323,330,235,6,95,0.0269121813031161,FALSE,95,2980,3,65,30,0.0318791946308725,0.0100671140939597,1,12,9
"200",41802068265,7,23,23,12,12,4,4,1,0,3600,743,523,400,415,9,-15,-0.00416666666666667,FALSE,-15,2980,2,75,-90,-0.00503355704697987,-0.0302013422818792,1,13,11
"201",41802068265,8,19,19,8,8,4,4,1,0,3700,418,203,500,90,5,410,0.110810810810811,FALSE,410,2980,2,75,335,0.13758389261745,0.11241610738255,1,9,7
"202",42468840454,2,17,16,6,6,5,5,2,1,3140,280,150,40,40,2,0,0,FALSE,0,2880,0,0,0,0,0,1,2,2
"203",42468840454,3,18,17,7,7,6,6,2,1,3250,311,181,150,71,3,79,0.0243076923076923,FALSE,79,2880,1,22,57,0.0274305555555556,0.0197916666666667,1,5,4
"204",42468840454,4,19,18,8,8,5,5,2,1,3290,370,240,190,130,4,60,0.0182370820668693,FALSE,60,2880,0,0,60,0.0208333333333333,0.0208333333333333,1,4,4
"205",42468840454,5,19,18,8,8,5,5,2,1,3340,381,251,240,141,4,99,0.0296407185628743,FALSE,99,2880,1,22,77,0.034375,0.0267361111111111,1,6,5
"206",42468840454,6,20,19,9,9,6,6,3,1,3390,405,275,290,165,5,125,0.0368731563421829,FALSE,125,2880,0,0,125,0.0434027777777778,0.0434027777777778,1,5,5
"207",42468840454,7,21,20,10,10,7,7,3,1,3500,436,306,400,196,6,204,0.0582857142857143,FALSE,204,2880,1,22,182,0.0708333333333333,0.0631944444444444,1,8,7
"208",42468840454,8,22,21,11,11,8,8,3,1,3440,508,378,340,268,7,72,0.0209302325581395,FALSE,72,2880,1,22,50,0.025,0.0173611111111111,1,9,8
"209",42681494957,2,16,16,12,12,5,5,0,1,3340,345,270,140,85,3,55,0.0164670658682635,FALSE,55,3050,2,65,-10,0.0180327868852459,-0.00327868852459016,1,7,5
"210",42681494957,3,18,18,14,14,7,7,0,1,3440,389,314,240,129,5,111,0.0322674418604651,FALSE,111,3050,2,65,46,0.0363934426229508,0.0150819672131148,1,9,7
"211",42681494957,4,20,20,15,15,9,9,0,0,3660,489,384,460,229,7,231,0.0631147540983607,FALSE,231,3050,3,105,126,0.0757377049180328,0.0413114754098361,1,13,10
"212",42681494957,5,20,20,15,15,9,9,0,0,3750,550,445,550,290,7,260,0.0693333333333333,FALSE,260,3050,3,105,155,0.0852459016393443,0.0508196721311475,1,13,10
"213",42981617542,2,12,12,12,12,0,0,1,0,3269,295,295,60,80,2,-20,-0.00611807892321811,FALSE,-20,2999,0,0,-20,-0.00666888962987663,-0.00666888962987663,1,2,2
"214",42981617542,3,13,13,13,13,0,0,1,0,3429,335,335,220,120,3,100,0.0291630212890055,FALSE,100,2999,1,20,80,0.0333444481493831,0.0266755585195065,1,5,4
"215",42981617542,4,14,14,14,14,0,0,1,1,3549,369,369,340,154,4,186,0.0524091293322063,FALSE,186,2999,2,25,161,0.0620206735578526,0.0536845615205068,1,8,6
"216",42981617542,5,14,14,14,14,0,0,1,2,3749,289,289,540,74,4,466,0.124299813283542,FALSE,466,2999,2,25,441,0.155385128376125,0.14704901633878,1,8,6
"217",42981617542,6,15,15,15,15,0,0,1,2,3999,435,435,790,220,5,570,0.142535633908477,FALSE,570,2999,2,25,545,0.190063354451484,0.181727242414138,1,9,7
"218",42981617542,7,16,16,16,16,0,0,1,0,3789,690,690,580,475,6,105,0.0277117973079968,FALSE,105,2999,1,20,85,0.0350116705568523,0.0283427809269757,1,8,7
"219",42981617542,8,17,17,17,17,0,0,1,2,4099,635,635,890,420,7,470,0.114662112710417,FALSE,470,2999,2,25,445,0.156718906302101,0.148382794264755,1,11,9
"220",43168072227,2,20,18,19,17,4,4,0,4,4442.86,375,325,57.1499999999996,15,1,42.1499999999996,0.00948713216261589,FALSE,42.1499999999996,4028.57,0,0,42.1499999999996,0.0104627696676487,0.0104627696676487,1,1,1
"221",43168072227,3,20,18,19,17,5,5,1,4,4528.57,356,306,142.86,-4,1,146.86,0.032429663227023,FALSE,146.86,4028.57,2,102,44.8599999999997,0.0364546228562492,0.0111354649416542,1,5,3
"222",43168072227,4,23,21,23,21,5,5,1,4,4642.86,435,435,257.15,75,4,182.15,0.0392322835493639,FALSE,182.15,4028.57,4,162,20.1499999999996,0.0452145550406223,0.00500177482332431,1,12,8
"223",43168072227,5,24,22,23,21,5,5,1,4,4757.14,496,446,371.43,136,5,235.43,0.0494898195134052,FALSE,235.43,4028.57,3,112,123.43,0.0584400916454226,0.0306386633470438,1,11,8
"224",43168072227,6,23,21,23,21,6,6,2,4,4828.57,435,435,442.86,75,4,367.86,0.0761840462082976,FALSE,367.86,4028.57,4,162,205.86,0.0913127983378717,0.0511000181205737,1,12,8
"225",43168072227,7,26,24,25,23,7,7,2,4,4900,601,551,514.29,241,7,273.29,0.0557734693877551,FALSE,273.29,4028.57,3,132,141.29,0.0678379673184281,0.0350719982524816,1,13,10
"226",43168072227,8,26,24,25,23,7,7,2,4,5000,623,573,614.29,263,7,351.29,0.070258,FALSE,351.29,4028.57,3,132,219.29,0.0871996763119419,0.0544337072459955,1,13,10
"227",43426870825,2,11,11,6,6,3,3,0,1,3379,260,200,100,25,2,75,0.0221959159514649,FALSE,75,3179,1,20,55,0.0235923246303869,0.0173010380622837,1,4,3
"228",43426870825,3,12,12,7,7,3,3,0,1,3479,320,260,200,85,3,115,0.0330554757114113,FALSE,115,3179,1,20,95,0.0361748977665933,0.0298836111984901,1,5,4
"229",43426870825,4,12,12,7,7,4,4,1,1,3679,320,260,400,85,3,315,0.0856210926882305,FALSE,315,3179,1,20,295,0.099087763447625,0.0927964768795219,1,5,4
"230",43426870825,5,12,12,7,7,4,4,1,1,3779,335,275,500,100,3,400,0.10584810796507,FALSE,400,3179,1,20,380,0.125825731362064,0.11953444479396,1,5,4
"231",43452978184,2,9,9,4,4,2,2,1,0,3478,195,135,60,33,1,27,0.00776308223116734,FALSE,27,3288,2,52,-25,0.00821167883211679,-0.00760340632603406,1,5,3
"232",43452978184,3,9,9,4,4,3,3,1,0,3638,475,415,220,313,1,-93,-0.025563496426608,FALSE,-93,3288,2,52,-145,-0.0282846715328467,-0.0440997566909976,1,5,3
"233",43452978184,4,10,10,5,5,3,3,1,0,3688,515,455,270,353,2,-83,-0.0225054229934924,FALSE,-83,3288,2,52,-135,-0.0252433090024331,-0.0410583941605839,1,6,4
"234",43473279886,2,1,1,1,1,0,0,0,0,2865,25,25,-5,-35,0,30,0.0104712041884817,FALSE,30,2820,1,60,-30,0.0106382978723404,-0.0106382978723404,1,2,1
"235",43473279886,3,1,1,1,1,0,0,0,0,2880,30,30,10,-30,0,40,0.0138888888888889,FALSE,40,2820,1,60,-20,0.0141843971631206,-0.00709219858156028,1,2,1
"236",43473279886,4,2,2,2,2,0,0,0,0,2915,85,85,45,25,1,20,0.00686106346483705,FALSE,20,2820,0,0,20,0.00709219858156028,0.00709219858156028,1,1,1
"237",43473279886,5,2,2,2,2,0,0,0,0,2940,90,90,70,30,1,40,0.0136054421768707,FALSE,40,2820,1,60,-20,0.0141843971631206,-0.00709219858156028,1,1,0
"238",43736454825,2,16,16,16,16,8,8,0,1,3210,416,416,30,11,0,19,0.0059190031152648,FALSE,19,2960,1,22,-3,0.00641891891891892,-0.00101351351351351,1,2,1
"239",43736454825,3,18,18,18,18,9,9,0,1,3280,466,466,100,61,2,39,0.011890243902439,FALSE,39,2960,2,102,-63,0.0131756756756757,-0.0212837837837838,1,6,4
"240",43736454825,4,21,21,20,20,11,11,0,1,3370,591,541,190,186,5,4,0.00118694362017804,FALSE,4,2960,3,137,-133,0.00135135135135135,-0.0449324324324324,1,11,8
"241",43736454825,5,20,20,20,20,10,10,0,1,3430,563,563,250,158,4,92,0.0268221574344023,FALSE,92,2960,3,137,-45,0.0310810810810811,-0.0152027027027027,1,10,7
"242",43736454825,6,21,21,21,21,10,10,0,1,3500,540,540,320,135,5,185,0.0528571428571429,FALSE,185,2960,2,115,70,0.0625,0.0236486486486486,1,9,7
"243",43736454825,7,23,23,22,22,13,13,1,2,3570,638,588,390,233,7,157,0.0439775910364146,FALSE,157,2960,4,155,2,0.0530405405405405,0.000675675675675676,1,13,9
"244",43736454825,8,24,24,23,23,14,14,1,1,3670,775,675,490,370,8,120,0.0326975476839237,FALSE,120,2960,4,155,-35,0.0405405405405405,-0.0118243243243243,1,16,12
"245",43853759026,2,14,14,14,14,2,2,1,0,3499,338,338,49,11,0,38,0.0108602457845099,FALSE,38,3199,1,22,16,0.0118787120975305,0.00500156298843389,1,2,1
"246",43853759026,3,14,14,14,14,2,2,1,0,3550,360,360,100,33,0,67,0.0188732394366197,FALSE,67,3199,1,22,45,0.0209440450140669,0.0140668959049703,1,2,1
"247",43853759026,4,15,15,15,15,2,2,1,0,3599,387,387,149,60,1,89,0.0247290914142817,FALSE,89,3199,0,0,89,0.0278211941231635,0.0278211941231635,1,1,1
"248",43853759026,5,15,15,15,15,2,2,1,0,3650,398,398,200,71,1,129,0.0353424657534247,FALSE,129,3199,1,22,107,0.0403251015942482,0.0334479524851516,1,3,2
"249",43853759026,6,16,16,16,16,4,4,2,0,3750,462,462,300,135,2,165,0.044,FALSE,165,3199,0,0,165,0.0515786183182244,0.0515786183182244,1,2,2
"250",43853759026,7,16,16,16,16,4,4,2,0,3799,473,473,349,146,2,203,0.0534351145038168,FALSE,203,3199,1,22,181,0.0634573304157549,0.0565801813066583,1,4,3
"251",43853759026,8,16,16,16,16,4,4,2,0,3850,495,495,400,168,2,232,0.0602597402597403,FALSE,232,3199,1,22,210,0.0725226633322913,0.0656455142231947,1,4,3
"252",43859660891,2,16,16,0,0,1,1,0,0,3020,360,0,20,5,0,15,0.00496688741721854,FALSE,15,2740,1,15,0,0.00547445255474453,0,1,2,1
"253",43859660891,3,16,16,0,0,1,1,0,0,3050,375,0,50,20,0,30,0.00983606557377049,FALSE,30,2740,1,15,15,0.0109489051094891,0.00547445255474453,1,2,1
"254",43859660891,4,16,16,0,0,1,1,0,0,3120,399,0,120,44,0,76,0.0243589743589744,FALSE,76,2740,1,15,61,0.0277372262773723,0.0222627737226277,1,2,1
"255",43859660891,5,17,17,3,3,1,1,1,0,3320,430,125,320,75,1,245,0.0737951807228916,FALSE,245,2740,0,0,245,0.0894160583941606,0.0894160583941606,1,1,1
"256",43859660891,6,17,17,0,0,1,1,1,0,3340,435,0,340,80,1,260,0.0778443113772455,FALSE,260,2740,1,15,245,0.0948905109489051,0.0894160583941606,1,3,2
"257",43859660891,7,17,17,0,0,1,1,1,0,3370,450,0,370,95,1,275,0.0816023738872404,FALSE,275,2740,1,15,260,0.10036496350365,0.0948905109489051,1,3,2
"258",43859660891,8,17,17,0,0,1,1,1,0,3440,474,0,440,119,1,321,0.0933139534883721,FALSE,321,2740,1,15,306,0.117153284671533,0.111678832116788,1,3,2
"259",44021641588,2,16,16,11,11,16,16,2,0,3220,432,227,40,22,1,18,0.00559006211180124,FALSE,18,2980,0,0,18,0.00604026845637584,0.00604026845637584,1,1,1
"260",44021641588,3,16,16,11,11,16,16,2,0,3240,443,238,60,33,1,27,0.00833333333333333,FALSE,27,2980,0,0,27,0.00906040268456376,0.00906040268456376,1,1,1
"261",44021641588,4,16,16,11,11,16,16,2,0,3280,465,260,100,55,1,45,0.013719512195122,FALSE,45,2980,0,0,45,0.0151006711409396,0.0151006711409396,1,1,1
"262",44069100271,2,15,15,15,15,2,2,1,1,3499,333,333,49,11,0,38,0.0108602457845099,FALSE,38,3199,1,22,16,0.0118787120975305,0.00500156298843389,1,2,1
"263",44069100271,3,15,15,15,15,2,2,1,1,3550,355,355,100,33,0,67,0.0188732394366197,FALSE,67,3199,1,22,45,0.0209440450140669,0.0140668959049703,1,2,1
"264",44069100271,4,16,16,16,16,2,2,1,1,3599,382,382,149,60,1,89,0.0247290914142817,FALSE,89,3199,0,0,89,0.0278211941231635,0.0278211941231635,1,1,1
"265",44069100271,5,16,16,16,16,3,3,1,1,3650,393,393,200,71,1,129,0.0353424657534247,FALSE,129,3199,1,22,107,0.0403251015942482,0.0334479524851516,1,3,2
"266",44069100271,6,16,16,16,16,3,3,2,1,3750,422,422,300,100,1,200,0.0533333333333333,FALSE,200,3199,0,0,200,0.0625195373554236,0.0625195373554236,1,1,1
"267",44069100271,7,16,16,16,16,3,3,2,1,3799,433,433,349,111,1,238,0.0626480652803369,FALSE,238,3199,1,22,216,0.074398249452954,0.0675211003438575,1,3,2
"268",44069100271,8,16,16,16,16,3,3,2,1,3850,455,455,400,133,1,267,0.0693506493506494,FALSE,267,3199,1,22,245,0.0834635823694905,0.0765864332603939,1,3,2
"269",44231886556,2,17,14,14,12,0,0,0,4,3838,355,335,175,130,5,45,0.0117248566961959,FALSE,45,3458,2,25,20,0.0130133024869867,0.00578368999421631,1,9,7
"270",44231886556,3,18,15,13,11,0,0,0,4,4038,510,380,375,285,6,90,0.0222882615156018,FALSE,90,3458,4,50,40,0.0260266049739734,0.0115673799884326,1,14,10
"271",44231886556,4,21,18,16,14,0,0,0,4,4128,600,560,465,375,9,90,0.0218023255813953,FALSE,90,3458,4,50,40,0.0260266049739734,0.0115673799884326,1,17,13
"272",44331296085,2,8,8,8,8,0,0,1,0,3238,290,290,110,40,1,70,0.0216182828906733,FALSE,70,2838,1,25,45,0.0246652572233968,0.0158562367864693,1,3,2
"273",44331296085,3,11,11,11,11,0,0,2,0,3558,437,437,430,187,4,243,0.0682967959527825,FALSE,243,2838,3,135,108,0.0856236786469345,0.0380549682875264,1,10,7
"274",44799642380,2,18,18,18,18,4,4,0,0,3417.92,385,385,20.2400000000002,5,0,15.2400000000002,0.00445885216740013,FALSE,15.2400000000002,3137.2,1,20,-4.75999999999976,0.00485783501211279,-0.00151727655233959,1,2,1
"275",44799642380,3,18,18,18,18,4,4,0,0,3447.84,390,390,50.1600000000003,10,0,40.1600000000003,0.0116478722910577,FALSE,40.1600000000003,3137.2,1,20,20.1600000000003,0.0128012240214205,0.0064261124569681,1,2,1
"276",44799642380,4,18,18,18,18,4,4,0,0,3517.36,415,415,119.68,35,0,84.6800000000003,0.0240748743375714,FALSE,84.6800000000003,3137.2,1,20,64.6800000000003,0.0269922223638915,0.0206171107994391,1,2,1
"277",44799642380,5,21,21,21,21,6,6,1,0,3708.32,690,690,310.64,310,3,0.640000000000327,0.000172584890192952,FALSE,0.640000000000327,3137.2,1,20,-19.3599999999997,0.00020400357006258,-0.0061711079943898,1,5,4
"278",44799642380,6,21,21,21,21,6,6,1,0,3737.36,695,695,339.68,315,3,24.6800000000003,0.00660359184022954,FALSE,24.6800000000003,3137.2,2,40,-15.3199999999997,0.00786688767053433,-0.00488333545837043,1,7,5
"279",44799642380,7,21,21,21,21,6,6,1,0,3767.28,700,700,369.6,320,3,49.6000000000004,0.0131659977490392,FALSE,49.6000000000004,3137.2,2,40,9.60000000000036,0.015810276679842,0.00306005355093726,1,7,5
"280",44799642380,8,21,21,21,21,6,6,1,0,3837.68,725,725,440,345,3,95,0.0247545392007671,FALSE,95,3137.2,2,40,55,0.0302817799311488,0.017531556802244,1,7,5
"281",44881048637,2,7,7,7,7,2,2,0,0,3485,375,375,157,35,2,122,0.0350071736011478,FALSE,122,2850,1,20,102,0.0428070175438596,0.0357894736842105,1,4,3
"282",44881048637,3,7,7,7,7,3,3,0,0,3872,363,363,544,23,2,521,0.134555785123967,FALSE,521,2850,3,210,311,0.18280701754386,0.109122807017544,1,8,5
"283",44881048637,4,10,10,10,10,4,4,0,0,4155,525,525,827,185,5,642,0.154512635379061,FALSE,642,2850,3,210,432,0.225263157894737,0.151578947368421,1,11,8
"284",45219159638,2,14,14,11,11,0,0,0,1,2725,410,340,5,-35,0,40,0.0146788990825688,FALSE,40,2680,1,60,-20,0.0149253731343284,-0.00746268656716418,1,2,1
"285",45219159638,3,15,15,12,12,0,0,0,1,2765,470,400,45,25,1,20,0.00723327305605787,FALSE,20,2680,0,0,20,0.00746268656716418,0.00746268656716418,1,1,1
"286",45219159638,4,15,15,12,12,0,0,0,1,2785,475,405,65,30,1,35,0.0125673249551167,FALSE,35,2680,0,0,35,0.0130597014925373,0.0130597014925373,1,1,1
"287",45293052304,2,13,13,13,13,1,1,0,1,3310,300,300,60,13,0,47,0.0141993957703927,FALSE,47,3100,1,22,25,0.0151612903225806,0.00806451612903226,1,2,1
"288",45293052304,3,13,13,13,13,1,1,0,1,3410,320,320,160,33,0,127,0.0372434017595308,FALSE,127,3100,1,22,105,0.0409677419354839,0.0338709677419355,1,2,1
"289",45293052304,4,16,15,16,15,2,2,1,2,3430,402,402,180,115,3,65,0.0189504373177843,FALSE,65,3100,0,0,65,0.0209677419354839,0.0209677419354839,1,3,3
"290",45293052304,5,16,15,16,15,2,2,1,2,3490,415,415,240,128,3,112,0.0320916905444126,FALSE,112,3100,1,22,90,0.0361290322580645,0.0290322580645161,1,5,4
"291",45293052304,6,16,15,16,15,2,2,1,2,3590,435,435,340,148,3,192,0.0534818941504178,FALSE,192,3100,1,22,170,0.0619354838709677,0.0548387096774194,1,5,4
"292",521513506795,2,18,16,11,9,5,5,0,2,3180,268,182,30,7,0,23,0.00723270440251572,FALSE,23,2960,1,15,8,0.00777027027027027,0.0027027027027027,1,2,1
"293",521513506795,3,21,19,13,11,6,6,0,2,3290,391,285,140,130,3,10,0.00303951367781155,FALSE,10,2960,1,50,-40,0.00337837837837838,-0.0135135135135135,1,5,4
"294",521513506795,4,21,19,13,11,6,6,0,2,3310,398,292,160,137,3,23,0.00694864048338369,FALSE,23,2960,2,65,-42,0.00777027027027027,-0.0141891891891892,1,7,5
"295",521513506795,5,22,20,14,12,6,6,0,2,3350,439,333,200,178,4,22,0.00656716417910448,FALSE,22,2960,2,65,-43,0.00743243243243243,-0.014527027027027,1,8,6
"296",521513506795,6,23,21,14,12,6,6,0,2,3350,586,365,200,325,5,-125,-0.0373134328358209,FALSE,-125,2960,2,75,-200,-0.0422297297297297,-0.0675675675675676,1,9,7
"297",521513506795,7,23,21,14,12,6,6,0,2,3380,593,372,230,332,5,-102,-0.0301775147928994,FALSE,-102,2960,3,90,-192,-0.0344594594594595,-0.0648648648648649,1,11,8
"298",521513506795,8,23,21,14,12,6,6,0,2,3430,609,388,280,348,5,-68,-0.0198250728862974,FALSE,-68,2960,3,90,-158,-0.022972972972973,-0.0533783783783784,1,11,8
"299",521870063421,2,11,11,8,8,11,11,0,0,3130,300,230,30,5,0,25,0.00798722044728434,FALSE,25,2950,1,20,5,0.00847457627118644,0.00169491525423729,1,2,1
"300",521870063421,3,10,10,8,8,10,10,0,0,3180,270,235,80,-25,-1,105,0.0330188679245283,FALSE,105,2950,2,55,50,0.0355932203389831,0.0169491525423729,1,3,1
"301",521870063421,4,12,12,10,10,12,12,1,0,3200,495,445,100,200,1,-100,-0.03125,FALSE,-100,2950,1,20,-120,-0.0338983050847458,-0.0406779661016949,1,3,2
"302",521870063421,5,12,12,10,10,12,12,1,0,3230,485,450,130,190,1,-60,-0.0185758513931889,FALSE,-60,2950,2,55,-115,-0.0203389830508475,-0.0389830508474576,1,5,3
"303",521870063421,6,13,13,10,10,13,13,1,0,3280,510,455,180,215,2,-35,-0.0106707317073171,FALSE,-35,2950,2,55,-90,-0.011864406779661,-0.0305084745762712,1,4,2
"304",522033862841,2,20,19,3,3,20,19,0,2,3370,385,135,20,5,0,15,0.00445103857566766,FALSE,15,3050,1,20,-5,0.00491803278688525,-0.00163934426229508,1,2,1
"305",522033862841,3,20,19,3,3,20,19,0,2,3400,390,140,50,10,0,40,0.0117647058823529,FALSE,40,3050,1,20,20,0.0131147540983607,0.00655737704918033,1,2,1
"306",522033862841,4,20,19,3,3,20,19,0,2,3470,415,165,120,35,0,85,0.0244956772334294,FALSE,85,3050,1,20,65,0.0278688524590164,0.0213114754098361,1,2,1
"307",522033862841,5,23,22,4,4,23,22,1,2,3600,670,205,250,290,3,-40,-0.0111111111111111,FALSE,-40,3050,1,40,-80,-0.0131147540983607,-0.0262295081967213,1,5,4
"308",522033862841,6,22,21,4,4,22,21,1,1,3620,675,210,270,295,2,-25,-0.0069060773480663,FALSE,-25,3050,3,60,-85,-0.00819672131147541,-0.0278688524590164,1,8,5
"309",522033862841,7,23,22,4,4,23,22,1,2,3650,680,215,300,300,3,0,0,FALSE,0,3050,2,60,-60,0,-0.019672131147541,1,7,5
"310",522033862841,8,24,23,4,4,24,23,1,3,3720,705,240,370,325,4,45,0.0120967741935484,FALSE,45,3050,2,60,-15,0.0147540983606557,-0.00491803278688525,1,6,4
"311",522086451970,2,6,5,3,2,0,0,0,1,3430,173,43,30,11,0,19,0.00553935860058309,FALSE,19,3300,1,22,-3,0.00575757575757576,-0.000909090909090909,1,2,1
"312",522086451970,3,6,5,3,2,0,0,0,1,3500,195,65,100,33,0,67,0.0191428571428571,FALSE,67,3300,1,22,45,0.0203030303030303,0.0136363636363636,1,2,1
"313",522086451970,4,8,7,4,3,0,0,0,1,3700,285,125,300,123,2,177,0.0478378378378378,FALSE,177,3300,1,22,155,0.0536363636363636,0.046969696969697,1,4,3
"314",522086451970,5,8,7,4,3,0,0,1,1,3800,300,140,400,138,2,262,0.0689473684210526,FALSE,262,3300,1,22,240,0.0793939393939394,0.0727272727272727,1,4,3
"315",522086451970,6,8,7,4,3,0,0,1,1,3900,300,140,500,138,2,362,0.0928205128205128,FALSE,362,3300,1,22,340,0.10969696969697,0.103030303030303,1,4,3
"316",522097809685,2,15,15,3,3,15,15,0,1,3423.21,262,102,28.4099999999999,7,0,21.4099999999999,0.00625436359440404,FALSE,21.4099999999999,3247,1,15,6.40999999999985,0.00659377887280562,0.00197412996612253,1,2,1
"317",522097809685,3,17,17,5,5,17,17,0,1,3505.5,375,215,110.7,120,2,-9.30000000000018,-0.00265297389816009,FALSE,-9.30000000000018,3247,1,50,-59.3000000000002,-0.00286418232214357,-0.0182630120110872,1,4,3
"318",522097809685,4,19,19,7,7,19,19,1,1,3533.18,450,290,138.38,195,4,-56.6200000000003,-0.0160252237361245,FALSE,-56.6200000000003,3247,2,65,-121.62,-0.0174376347397599,-0.0374561133353866,1,8,6
"319",522097809685,5,19,19,7,7,19,19,1,1,3570.08,461,301,175.28,206,4,-30.7200000000003,-0.00860484919105461,FALSE,-30.7200000000003,3247,2,65,-95.7200000000003,-0.00946104096088705,-0.0294795195565138,1,8,6
"320",522097809685,6,17,17,5,5,17,17,0,1,3588.53,382,222,193.73,127,2,66.73,0.0185953579878112,FALSE,66.73,3247,2,65,1.73000000000002,0.0205512781028642,0.000532799507237456,1,6,4
"321",522097809685,7,18,18,6,6,18,18,0,1,3625.43,443,263,230.63,188,3,42.6299999999997,0.0117586051861433,FALSE,42.6299999999997,3247,3,85,-42.3700000000003,0.0131290421927932,-0.0130489682784109,1,9,6
"322",522097809685,8,18,18,6,6,18,18,0,1,3662.33,465,285,267.53,210,3,57.5299999999997,0.0157085789647573,FALSE,57.5299999999997,3247,3,85,-27.4700000000003,0.0177178934400985,-0.00846011703110571,1,9,6
"323",522145128789,2,16,15,4,3,2,2,2,1,3330,427,107,30,37,1,-7,-0.0021021021021021,FALSE,-7,3050,1,20,-27,-0.00229508196721311,-0.00885245901639344,1,3,2
"324",522145128789,3,16,15,4,3,2,2,2,1,3380,438,118,80,48,1,32,0.00946745562130178,FALSE,32,3050,1,20,12,0.0104918032786885,0.0039344262295082,1,3,2
"325",522145128789,4,17,16,5,4,2,2,2,1,3410,510,190,110,120,2,-10,-0.00293255131964809,FALSE,-10,3050,1,20,-30,-0.00327868852459016,-0.00983606557377049,1,4,3
"326",522145128789,5,17,16,5,4,2,2,2,1,3380,475,155,80,85,2,-5,-0.0014792899408284,FALSE,-5,3050,0,0,-5,-0.00163934426229508,-0.00163934426229508,1,2,2
"327",522145128789,6,17,16,5,4,2,2,2,1,3410,477,157,110,87,2,23,0.00674486803519062,FALSE,23,3050,1,20,3,0.00754098360655738,0.000983606557377049,1,4,3
"328",522145128789,7,17,16,5,4,3,3,3,1,3560,513,193,260,123,2,137,0.0384831460674157,FALSE,137,3050,1,20,117,0.0449180327868852,0.0383606557377049,1,4,3
"329",522145128789,8,17,16,5,4,3,3,3,1,3640,535,215,340,145,2,195,0.0535714285714286,FALSE,195,3050,1,20,175,0.0639344262295082,0.0573770491803279,1,4,3
"330",522743875767,2,18,18,18,18,0,0,0,0,3330,385,385,20,5,0,15,0.0045045045045045,FALSE,15,3050,1,20,-5,0.00491803278688525,-0.00163934426229508,1,2,1
"331",522743875767,3,18,18,18,18,0,0,0,0,3360,390,390,50,10,0,40,0.0119047619047619,FALSE,40,3050,1,20,20,0.0131147540983607,0.00655737704918033,1,2,1
"332",522743875767,4,18,18,18,18,0,0,0,0,3430,415,415,120,35,0,85,0.0247813411078717,FALSE,85,3050,1,20,65,0.0278688524590164,0.0213114754098361,1,2,1
"333",522743875767,5,19,19,19,19,0,0,1,0,3610,455,455,300,75,1,225,0.0623268698060942,FALSE,225,3050,0,0,225,0.0737704918032787,0.0737704918032787,1,1,1
"334",522743875767,6,19,19,19,19,0,0,1,0,3630,460,460,320,80,1,240,0.0661157024793388,FALSE,240,3050,1,20,220,0.0786885245901639,0.0721311475409836,1,3,2
"335",522743875767,7,19,19,19,19,0,0,1,0,3660,465,465,350,85,1,265,0.0724043715846995,FALSE,265,3050,1,20,245,0.0868852459016393,0.080327868852459,1,3,2
"336",522743875767,8,19,19,19,19,0,0,1,0,3730,490,490,420,110,1,310,0.0831099195710456,FALSE,310,3050,1,20,290,0.101639344262295,0.0950819672131148,1,3,2
"337",522863996797,2,19,19,15,15,5,5,2,0,3190,732,602,40,22,1,18,0.00564263322884012,FALSE,18,2950,0,0,18,0.00610169491525424,0.00610169491525424,1,1,1
"338",522863996797,3,19,19,15,15,6,6,2,0,3210,743,613,60,33,1,27,0.00841121495327103,FALSE,27,2950,0,0,27,0.00915254237288136,0.00915254237288136,1,1,1
"339",522863996797,4,19,19,15,15,4,4,2,0,3250,765,635,100,55,1,45,0.0138461538461538,FALSE,45,2950,0,0,45,0.0152542372881356,0.0152542372881356,1,1,1
"340",523084126902,2,15,13,3,3,5,5,2,3,3330,281,135,80,20,0,60,0.018018018018018,FALSE,60,3050,1,35,25,0.019672131147541,0.00819672131147541,1,2,1
"341",523084126902,3,16,14,4,4,6,6,2,3,3350,311,165,100,50,1,50,0.0149253731343284,FALSE,50,3050,0,0,50,0.0163934426229508,0.0163934426229508,1,1,1
"342",523084126902,4,16,14,4,4,7,6,2,3,3400,331,185,150,70,1,80,0.0235294117647059,FALSE,80,3050,1,35,45,0.0262295081967213,0.0147540983606557,1,3,2
"343",523084126902,5,16,14,4,4,6,6,3,3,3500,336,190,250,75,1,175,0.05,FALSE,175,3050,0,0,175,0.0573770491803279,0.0573770491803279,1,1,1
"344",523084126902,6,16,14,4,4,6,6,3,3,3550,356,210,300,95,1,205,0.0577464788732394,FALSE,205,3050,1,35,170,0.0672131147540984,0.0557377049180328,1,3,2
"345",523084126902,7,18,16,6,6,8,8,3,3,4050,535,389,800,274,3,526,0.129876543209877,FALSE,526,3050,0,0,526,0.172459016393443,0.172459016393443,1,3,3
"346",523084126902,8,18,16,6,6,8,8,3,3,4100,555,409,850,294,3,556,0.135609756097561,FALSE,556,3050,1,35,521,0.182295081967213,0.170819672131148,1,5,4
"347",523776961013,2,6,6,5,5,6,6,0,0,4898,160,150,40,5,0,35,0.00714577378521846,FALSE,35,4638,1,25,10,0.00754635618801207,0.00215610176800345,1,2,1
"348",523776961013,3,10,10,9,9,10,10,0,0,5008,365,355,150,210,4,-60,-0.0119808306709265,FALSE,-60,4638,0,0,-60,-0.0129366106080207,-0.0129366106080207,1,4,4
"349",523776961013,4,10,10,9,9,10,10,0,0,5048,370,360,190,215,4,-25,-0.00495245641838352,FALSE,-25,4638,1,25,-50,-0.00539025442000862,-0.0107805088400172,1,6,5
"350",523776961013,5,10,10,9,9,10,10,0,0,5138,395,385,280,240,4,40,0.00778513040093422,FALSE,40,4638,1,25,15,0.0086244070720138,0.00323415265200517,1,6,5
"351",523776961013,6,14,14,13,13,14,14,0,1,5198,800,790,340,645,8,-305,-0.0586764140053867,FALSE,-305,4638,1,25,-330,-0.0657611039241052,-0.0711513583441138,1,10,9
"352",523776961013,7,14,14,13,13,14,14,0,1,5288,825,815,430,670,8,-240,-0.0453857791225416,FALSE,-240,4638,1,25,-265,-0.0517464424320828,-0.0571366968520914,1,10,9
